F 84		,57			,34
SO ./textures/cracked_polished_blackstone_bricks.xpm
C 139,216,		223
NO ./textures/cracked_deepslate_tiles.xpm
WE ./textures/stripped_spruce_log.xpm

EA															./textures/spruce_planks.xpm
        1111111111111111111111111
        100D000000110000000000001
        1011000001110000000000001
        10010000000D0000W00000001
111111111011000001110000000000001
1000000000110000011101111111D1111
11110111111111D111000000100000001
11110111111111011101010010000000111
11000000110101011100000010000000D01
10000000000000001100000010000000111
100000000000000011010100100000001
110000011101010111110111100011111
11110111 1110101 101111010001
11111111 1111111 111111111111
