		NO ./textures/examples0.xpm
	SO ./textures/examples1.xpm
WE ./textures/examples2.xpm
EA ./textures/examples3.xpm

C						225					,30,	0

		F 255,100,0





11111112
1N011
1111111
